name,rating,gamesPlayed,goalDifference,wins,draws,points
Invincible Gunners,95,38,+47,26,12,90
Silver Knights,94,30,+40,20,10,70
Bronze Satisfiers,92,28,+30,14,14,56
Rusty Warriors,90,24,+25,15,9,54
Squanchy Punishers,89,22,+24,14,8,50
Forward Pushers,87,18,+19,13,5,44
Fast Boys,86.5,14,+17,10,4,34
Meer Cats,85,12,+14,8,4,27
Crazy Puckers,83.69,10,+12,7,3,24
Sharp Debuggers,87.06,10,+8,5,5,20
